2 2 2 2 2 2 2 2 2 2 1 1 1 1 1 1 1 1 1 1 1 1 1 1 1 1 1 1 1 1 1 1 1
2 0 0 0 0 0 0 0 0 2 0 0 0 0 0 0 0 0 0 0 0 1 0 0 0 0 0 0 0 0 0 0 1
2 0 0 0 0 0 0 0 0 2 0 0 0 0 0 0 0 0 0 0 0 1 0 0 0 0 0 0 0 0 0 0 1
2 0 0 0 0 0 0 0 0 5 0 0 0 0 0 0 0 0 0 0 0 1 0 0 0 0 0 0 0 0 0 0 1
2 0 0 0 0 0 0 0 0 2 1 1 1 1 1 1 1 1 1 5 1 1 1 1 1 1 1 1 1 1 1 1 1
2 0 0 0 0 0 0 0 0 2 3 3 3 3 3 3 3 3 3 0 3 3 3 3 3 3 3 3 3 3 3 3 1
2 0 0 0 0 0 0 0 0 2 3 0 0 0 0 0 0 0 0 0 0 0 0 3 0 0 0 0 0 0 0 0 3
2 2 2 0 2 2 2 2 2 2 3 0 0 0 0 0 0 0 0 0 0 0 0 3 0 0 0 0 0 0 0 0 3
1 1 1 5 1 1 1 1 1 1 3 0 0 0 0 0 0 0 0 0 0 0 0 5 0 0 0 0 0 0 0 0 3
1 0 0 0 0 0 1 0 0 0 9 0 0 0 0 0 0 0 0 0 0 0 0 3 0 0 0 0 0 0 0 3 1
1 0 0 0 0 0 1 0 0 1 3 0 0 0 0 0 0 0 0 0 0 0 0 3 0 0 0 0 0 0 0 3 1
1 0 0 0 0 0 1 0 0 1 3 3 3 3 3 5 3 3 3 3 3 3 3 3 3 3 3 3 3 3 3 3 1
1 0 0 0 0 0 1 0 0 1 4 4 4 4 4 0 4 4 4 4 3 0 0 0 0 0 0 0 0 0 3 0 1
1 0 0 0 0 0 1 0 0 1 4 0 0 0 0 0 0 0 0 0 5 0 0 0 0 0 0 0 0 0 3 1 1
1 0 0 0 0 0 1 0 0 1 4 0 0 0 0 0 0 0 0 4 3 0 0 0 0 0 0 0 0 0 3 1 1
1 0 0 0 0 0 1 0 0 1 4 0 0 0 0 0 0 0 0 4 3 0 0 0 0 0 0 0 0 0 3 1 1
1 0 0 0 0 0 1 0 0 1 4 4 4 4 4 4 4 4 4 3 3 3 3 3 3 3 3 3 3 3 3 1 1
1 1 1 1 1 1 1 1 1 1 1 1 1 1 1 1 1 1 1 1 1 1 1 1 1 1 1 1 1 1 1 1 1
